Bozatemur-Akdag	Aslihan	SPÖ
Brucker	Lukas	FPÖ
Burian	Lukas	NEOS
Bussek	Andreas	FPÖ
Däger-Gregori	Luise	SPÖ
Deutsch	Christian	SPÖ
Do Amaral Tavares Da Costa Sara		SPÖ
Ellensohn	David	GRÜNE
Gara	Stefan	NEOS
Gorlitzer	Michael	ÖVP
Gremel	Marcus	SPÖ
Gudenus	Clemens	FPÖ
Guggenberger	Roland	FPÖ
Guggenbichler	Udo	FPÖ
Haase	Susanne	SPÖ
Hanke	Marina	SPÖ
Holzmann	Ernst	SPÖ
Hu	Jing	NEOS
Huemer	Barbara	GRÜNE
Hungerländer	Caroline	ÖVP
In der Maur-Koenne 	Maria	NEOS
Irschik	Wolfgang	FPÖ
Juraczka	Manfred	ÖVP
Karner-Kremser	Waltraud	SPÖ
Keri	Sabine	ÖVP
Kickert	Jennifer	GRÜNE
Korosec	Ingrid	ÖVP
Kowarik	Dietbert	FPÖ
Krauss	Maximilian	FPÖ
Kreutzinger	Thomas	FPÖ
Laschan	Claudia	SPÖ
Löcker	Theodor	GRÜNE
Ludwig-Faymann	Martina	SPÖ
Lugner	Leo	FPÖ
Mader	Thomas	SPÖ
Mahdalik	Anton	FPÖ
Mahrer	Karl	ÖVP
Malle	Julia	GRÜNE
Mautz	Andrea	SPÖ
Mayer	Lorenz	ÖVP
Meidlinger	Christian	SPÖ
Neumayer	Jörg	SPÖ
Niedermühlbichler	Georg	SPÖ
Niegl	Michael	FPÖ
Obrecht	Sascha	SPÖ
Olischar	Elisabeth	ÖVP
Ornig	Markus	NEOS
Pany	Astrid	SPÖ
Pipal-Leixner	Angelika	NEOS
Poljak	Nikola	SPÖ
Prack	Georg	GRÜNE
Reindl	Thomas	SPÖ
Resch	Klemens	FPÖ
Rezaei	Alexandra	SPÖ
Rompolt	Astrid	SPÖ
Rychly	Yvonne	SPÖ
Šakic	Denis	SPÖ
Samel	Ewa	SPÖ
Saurer	Bernd	FPÖ
Schmid	Gerhard	SPÖ
Schmid	Roman	FPÖ
Schneckenreither	Theresa	GRÜNE
Schober	Marcus	SPÖ
Schulz	Benjamin	SPÖ
Schütz	Angela	FPÖ
Seidl	Alice	SPÖ
Seidl	Wolfgang	FPÖ
Sequenz	Heidemarie	GRÜNE
Spitzer	Gerhard	SPÖ
Stadler	Felix	GRÜNE
Stadler	Paul	FPÖ
Stark	Harald	FPÖ
Stark	Kilian	GRÜNE
Stumpf	Michael	FPÖ
Sucher	Cornelia	SPÖ
Taborsky	Hannes	ÖVP
Taucher	Josef	SPÖ
Trinko	Michael	SPÖ
Tufegdzic	Ilija	FPÖ
Vasold	Stefanie	SPÖ
Wagner	Kurt	SPÖ
Weber	Thomas	NEOS
Weninger	Katharina	SPÖ
Wirnsberger	Christina	GRÜNE
Worotynski	Filip	SPÖ
Zierfuß	Harald	ÖVP
